NO ./img/circles.xpm
SO ./img/circles.xpm
EA ./img/circles.xpm
WE ./img/circles.xpm
F 250,200,100
C 250,200,100
111111111111111111111111100
100000000011000000000000100
101100000111000000000000100
100100000000000000000000111111111
111111111011000001110000000000001
100000000011000001110111111111111
11110111111111011100000010001
11110111111111011101010010001
11000000110101011100000000001
10000000000000001100000010001
10000000000000001101010010001
11000001110101011111011110N0111
11110111 11101010101111010001
11111111 1111111011111111111100
