NO ./img/backroom_wall_2.xpm
SO ./img/backroom_wall_2.xpm
EA ./img/backroom_wall_2.xpm
WE ./img/backroom_wall_2.xpm

C ./img/backroom_ceiling.xpm
F ./img/backroom_floor.xpm

D ./img/backroom_door_2.xpm
e ./img/backroom_tardis.xpm

f ./img/enemy_korosensei.xpm
ex ./img/explosion_1_0.xpm ./img/explosion_1_1.xpm ./img/explosion_1_2.xpm ./img/explosion_1_3.xpm

11111111111111111111111111111111111111111111111111111111111111111111111111111111111111111111111111111111111111111111111111
10000000000100000000001000000000000000000000100000000001000000000010000000000100000000001000000000010000000000100000000001
10000000000100000000001000100010000010001000000000000001000000000010000000000100000000001000000000010000000000100000000001
10000000000000000000001001110111000111011100100000000001000000000010000010000100000000001000000000000000000000100000000001
10000000000100000000001000100010000010001000100000000000000000000010000111000100000000001000000000010000000000100000000001
10000000000100000000001000000000000000000000100000000001000000000010000010000000000000001000000000010000000000100000000001
10000000000100000000000000100010000010001000100000000001000000000010000000000100000000001000000000010000000000100000000001
10000000000100000000001001110111000111011100100000000001000000000000000010000100000000001000000000010000000000100000000001
1000000000010000000000100010001000001000100010000000000100000000001000011100010000000000D000000000010000000000000000000001
10000000000100000000001000000000000000000000100000000001000000000010000010000100000000001000000000010000000000100000000001
10000000000100000000001000100010000010001000100000000001000000000010000000000100000000001000000000010000000000100000000001
1111101111111110111111100111011100011101110011D1111111111111111D1111111011111111111011111111111D1111111111111011D111111111
10000000000100000000001000100010000010001000100000000001000000000010000000000100000000001000000000010000000000100000000001
1000000000010000000000100000000000000000000010011D111101000000000010000000000100010001001000000000010000000000100000000001
10000000000100000000001000100010000010001000100100000101000000000010000010000100111011101000000000010000000000100000000001
10000000000100000000001001110111000111011100D00100100101000000000010000111000100010001001000000000010000000000100000000001
10000000000100000000001000100010000010001000100101D1010100000f000010000010000100000000001000000000010000000000100000000001
10000000000100000000001000000000000000000000100100100101000000000010000000000100000000001000000000010000000000100000000001
1000000000010000000000100010001000001000100011110000010D000000000010000010000100010001001000000000010000000000100000000001
10000000000100000000001001110111000111011100100100000101000000000010000111000100111011101000000000010000000000100000000001
10000000000100000000001000100010000010001000D00111111101000000000010000010000100010001001000000000010000000000100000000001
10000000000100000000001000000000000000000000100000000001000000000010000000000100000000001000000000010000000000100000000001
11111111011111D111111111D1111111D111111D111111111D111111111111D111111111011111111011111111D111111111111111D111111D11111111
100000000001000000D000000000000000000000D000100000000001000000000010000000000100000000001000000000010000000000100000000001
1000000000010000001111111111D111111111111000D00000000001000000000010000000000100000000001000000000010000000000100000000001
10000000000D0001001000000001010011000D001000100000000001000000000010000000000100000000001000000000010000000000100000000001
100000000001001110D0000000000010000001001000111111111111000000000010000000000100000000001000000000010000000000100000000001
1000000000010001001001111111110011111100D000100000000001000000000010000000000100000000001000000000010000000000100000000001
100000000001000000100100D00010010D000100100010000000000D000000N000D00001D0000100000000001000000000010000000000100000000001
10000000000100010010010011111001011111D1100010000f000001000000000010000000000100000000001000000000010000000000100000000001
1000000000010011101000000000D0010000D0001000D00000000001000000000010000000000100000000001000000000010000000000100000000001
10000000000100010010001111111111111111111000100000000001000000000010000000000100000000001000000000010000000000100000000001
100000000001000000100010000000000D0000000000100000000001000000000010000000000100000000001000000000010000000000100000000001
111110111111011111111D10111111111111111111101011111111D111111D111111111111111111111111111111111111111011111111111111D11111
100000000001000000000010000000000D00000000001000000000010000000000100000000001000000000010f0000f00010000000000100000000001
100000000001000000000010000000000100000000001000000000010000000000100000000001000000000010000f000001000f000000100000000001
100000000001000000000010010000100100100001001000000000010f00000000100000000001000000000010f0000000010000000f00100f00000001
10000000000100000000001000000000010000000000100000000001000000000010000000000100000000001000f00f000D000000000010000000f001
100000000001000000000010000000000100000000001000000000010000000000100000000001000000000010f00f00f001000f000000100000000001
10000000000D000000000010010000100100100001001000000000010000000000100000000001000000000010000000000100000000001000f0000001
100000000001000000000010000000000D000000000010000000000100000000f01000000000010000000000100f00f00f010000000f00100000000001
100000000001000000000010000000000100000000001000000000010000000000100000000001000000000010000000000100f0000000100000000001
100000000001000000000010010000100100100001001000000000010000000000100000000001000000000010f00f0f0f010000000000100000000f01
10000000000100000000001000000000010000000000D00000000001000000000010000000000100000000001000000000010000000000100000000001
11D11111111111111111111111111111D1D11111111D1D1111111101111110111111111111111111111111111111111111111111111111111111111D11
10000000000100000000000000000000000000000000D00000000001000000000010000000000010000000010000100000010f10000100100100000001
100000000001000000000000000000000000000000001000000000010000000000100100001001000000000100000010000100D0000D00D00100000001
10000000000100111111111111111D11111111111100100000000001000000000010000010000Df00000000101D110000111D110000100100100000001
1000000000010010000000D000000000000D000001001000000000010000000000100f000000010000000000100000000001001000011D100100000001
10000000000100D00000001111111111111100000D0010000000000100000000001f000000000110010001D111100111100100100001f0111100000001
1000000000010010000000D000000000000D00000100100000000001000000000010f110000001000000000010000000000111111D111100001D111D11
10000000000100101111111111D111111111110001001000000000010000000000100001000001001001110010000000000100000001fD000010010001
1000000000010010000000000000000000000100010010000000000D00000000001000f0000101000000000010000000000Df00000011111D110010001
1000000000010010001001001000100100100100010010000000000100000000001ff01D1ffff10000f000001000000000010000000D00100010011111
1000000000010010011101011101110101110100010010000000000100000000001ef0f0f0000100000000001000000000010000000100D000100D0001
11111D111111001000100100100010010010010001000011111111111D11111D11111111111111110f01011111f1f1f1f1f11111111100100111111D11
10000000000100100000010000000001000001000100100000000001000010000010000000000100000000001000000000010000100011111100000001
100000000001000001111111110111111111000001001000000000010000100000100000000001001D1f1f001010101010110010000000100000000001
10000000000100100000010000000001000001000100100000000001000010000010000000000100000000001000000000010010000000100000000001
1000000000010010001001001000100100100100010010000000000100001000001000000000010f0000f0001000000000fD0000100000100000000001
10000000000100100111010111011101011101000100100000000001D1111111001000000000010000000000111000000001000010f000100000000001
1000000000010010001001001000100100100100010010000000000100001000001000000000011100001D111001D1000111111111D111100000000001
100000000001001000000000000000000000000001001000000000010000100000100000000001000000000010000f00000100f0100000100000000001
10000000000D00101111101111111110111111111100100000000001000010000010000000000100111100001000001110010f0010000fD00000000001
1000000000010000000010000000000010000000000010000000000111101011101000000000010000000000100000000001f00f100000100000000001
1000000000010000000000000001D100D000000000001000000000000000001000D00000000001000000010010000000f00100001000001000000f0001
11111D111111111111111111111101111111111111111111111111111111D11D11111111111111110100101111111111D1111D111111111111111D1111
100000000001000000000010000001000100000D00001000D001000D0001010000Df000000000100000000001000001fff00fff100000010f010f0f001
1000000000010000000000100000000001000001110010001001000100010101111000000000010000110000D000001000000001000000100010000001
100000000000000000000011101111000000011100001000100100010001f1f0001000000000010000000000100000111111111f111D1111D111D11111
100000000001111111100010001001000100010001111111101100010001D11110111011D111110000000000100000000001000000000010f010001001
10000000000100000010001000000100010001000000D000000100010000000000100000f00001000000000000100000001000000000001000D000D001
1000000000010000001000111111111111000100011111110001000100111111001000000000010000000000001000000001111D111111100010001001
100000000001000000100010000000000100010001000001000000010010f0f10010010000000D00000000000010000000010000000000111111D11111
10000000000000000010001000000000010001000100100100000001001f000100100000000001000000000000100000000000f0000000100000001001
1000000000010000000000D00000000000000111110010011111111100111D110010000000100100000000001000000000100000000000D00000000001
1000000000010000001000100000000001000D00000010000D000001000000000010000000000100000000001000000000010000000000100000010001
111111111111111111111111111111111111111111111111110000011111111111111111110111111111D1111111111111111111111111111111111D11
10000000000100000000001000000000010000000000100000000001000000000010000000000100000000001000000000010000000000101000000001
100000000001000000000010000000000100000000001000000000010000000000100f0000000100f00f00001000000000010000000000100010000001
1000000000010000000000100000000001000000000010000000000100000000001000000000010000f00f001000000000010000000000100000100001
100000000001000000000010000000000100000000001000000000010000000000100000f000010f000000001000000000010000000000100000001001
100000000001000000000010000000000100000000001000000000010000000000100000000001000f00f0f01000000000010000000000110000000001
1000000000010000000000100000000001000000000010000000000100000000001000f00000010f000000001000000000010000000000100100000001
1000000000010000000000100000000001000000000010000000000100000000001000000000010000f0f00f1000000000010000000000100000000101
10000000000100000000001000000000010000000000100000000001000000000010000000f001f00f0000001000000000010000000000100001000001
10000000000100000000001000000000010000000000100000000001000000000010000000000100f00f00f01000000000010000000000100000010001
10000000000100000000001000000000010000000000100000000001000000000010000000000100000000001000000000010000000000100000000011
11111111111111111111111111111111111111111111111111111111111111111111111111111111111111111111111111111111111111111111111111
