NO ./img/backroom_wall_2.xpm
SO ./img/backroom_wall_2.xpm
EA ./img/backroom_wall_2.xpm
WE ./img/backroom_wall_2.xpm

C ./img/backroom_ceiling.xpm
F ./img/backroom_floor.xpm

D ./img/backroom_door_2.xpm
e ./img/backroom_tardis.xpm

f ./img/enemy_korosensei.xpm
ex ./img/explosion_1_0.xpm ./img/explosion_1_1.xpm ./img/explosion_1_2.xpm ./img/explosion_1_3.xpm

11111111111111111111111111111111111111111111111111111111111111111111111111111111111111111111111111111111111111111111111111
10000000000100000000001000000000000000000000100000000001000000000010000000000100000000001000000000010000000000100000000001
10000000000100000000001000100010000010001000000000000001000000000010000000000100000000001000000000010000000000100000000001
10000000000000000000001001110111000111011100100000000001000000000010000010000100000000001000000000000000000000100000000001
10000000000100000000001000100010000010001000100000000000000000000010000111000100000000001000000000010000000000100000000001
1000000000010000000000100000f0000f0000f00000100000000001000000000010000010000000000000001000000000010000000000100000000001
10000000000100000000000000100010000010001000100000000001000000000010000000000100000000001000000000010000000000100000000001
10000000000100000000001001110111000111011100100000000001000000000000000010000100000000001000000000010000000000100000000001
1000000000010000000000100010001000001000100010000000000100000000001000011100010000000000D000000000010000000000000000000001
1000000000010000000000100000f0000f0000f00000100000000001000000000010000010000100000000001000000000010000000000100000000001
10000000000100000000001000100010000010001000100000000001000000000010000000000100000000001000000000010000000000100000000001
1111101111111110111111100111011100011101110011D1111111111111111D1111111011111111111011111111111D1111111111111011D111111111
10000000000100000000001000100010000010001000100000000001000000000010000000000100000000001000000000010000000000100000000001
1000000000010000000000100000f0000f0000f0000010011D111101000000000010000000000100010001001000000000010000000000100000000001
100000000001000000000010001000100000100010001001f000f101000000000010000010000100111011101000000000010000000000100000000001
10000000000100000000001001110111000111011100D00100100101000000000010000111000100010001001000000000010000000000100000000001
10000000000100000000001000100010000010001000100101D1010100000f000010000010000100000000001000000000010000000000100000000001
1000000000010000000000100000f0000f0000f00000100100100101000000000010000000000100000000001000000000010000000000100000000001
1000000000010000000000100010001000001000100011110000010D000000000010000010000100010001001000000000010000000000100000000001
100000000001000000000010011101110001110111001001f000f101000000000010000111000100111011101000000000010000000000100000000001
10000000000100000000001000100010000010001000D0011111110100f000000010000010000100010001001000000000010000000000100000000001
1000000000010000000000100000f0000f0000f00000100000f00001000000f00010000000000100000000001000000000010000000000100000000001
11111111f11111D111111111D1111111D111111D111111111D111111111111D111111111f11111111f11111111D111111111111111D111111D11111111
100000000001000000D000000000000000000000D000100000000001000000000010000000000100000000001000000000010000000000100000000001
1000000000010000001111111111D111111111111000D0000000000100000000001000000000010000000000100000000f010f0000f00010f000f00001
100f000000fD000100100000000101f011000D001000100000000001000000000010000000000100000000001000f0000001000000000f100000000001
100000000001001110D0000000000010000001001000111111111111000000000010000000000100000f0000100000000001000f000000100000000001
1000000000010001001001111111110011111100D00010000000000100000000001000000000010000000000100000f00001000000000010000000f001
100000000001000000100100D00f1001fD00f100100010000000000D000000N000D00001D00001000000000010000000f00100000000f01000f0000001
10000f00000100010010010011111001011111D1100010000f000001000000000010000000000100f00000f0100f000000010000f00000100000000001
100000000001001110100000000fDf01f000D00f1000D00000000001000000000010000000000100000000001000000f00010000000f00100000000001
1000000000010f0100100011111111111111111110001000000000010000000000100000000001000000f00010000000000100000f0000100f00f00001
100000000001000000100010000f00000D000000f000100000000001000000000010000000000100000000001000000000010000000000100000000001
11111f111111D11111111D1D111111111111111111101011111111D111111D111111111111111111111111111111111111111011111111111111D11111
100000000001000000000010000000000D00000000001000000000010000000000100000000001000000000010f0000f00010000000000100000000001
10000000000100000000f010000000000100000000001000000000010000000000100000000001000000000010000f000001000f000000100000000001
1000000000010000000000100100f010010010f001001000000000010f00000000100000000001000000000010f0000000010000000f00100f00000001
10000000000100000000001000000000010000000000100000000001000000000010000000000100000000001000f00f000D000000000010000000f001
100000000001000000000010000000000100000000001000000000010000000000100000000001000000000010f00f00f001000f000000100000000001
10000f00000D0f0000000010010f00100100100f01001000000000010000000000100000000001000000000010000000000100000000001000f0000001
100000000001000000000010000000000D000000000010000000000100000000f01000000000010000000000100f00f00f010000000f00100000000001
100000000001000000000010000000000100000000001000000000010000000000100000000001000000000010000000000100f0000000100000000001
1000000000010000000000100100f010010010f001001000000000010000000000100000000001000000000010f00f0f0f0100000000001000f0000f01
10000000000100000000001000000000010000000000D00000000001000000000010000000000100000000001000000000010000000000100000000001
11D11111111111111111111111111111D1D11111111D1D1111111101111110111111111111111111111111111111111111111111111111111111111D11
10000000000100000000000000000000000000000000D00000000001000000000010000f0000001000000001000f1000f0010f1000010010f100f00001
1000f000f001000000000000000000000000000000001000000000010000000000100100001001000000000100000010000100D0000D00D00100000001
10000000000100111111111111111D11111111111100100000000001000000000010000010f00Df00000000101D110000111D1100001001001000f0001
1000000000010010000000D00f000000f00D000f01001000000000010000000000100f000000010000000000100000000001001000011D10f100000f01
10000f00000100Df0000001111111111111100000D0010000000000100000000001f0000f0000110010001D11110011110010f100001f0111100000001
1000000000010010000000D0f0000f000f0D0000010010000000000100000000001ff11000f00100000000001f000000000111111D111100001D111D11
10000000000100101111111111D1111111111100010010000000000100000000001fff01000001001001110010000000000100000001fD000010010001
100f00000001001000000f000000000f00000100010010000000000Df0000000001fffff000101000000000010000000000Df00000011111D11001f001
1000000000010010001001001000100100100100010010000000000100000000001fff1D1ffff10000f000001000000000010000000D0010001f011111
100000000001001001110101110111010111010001001000000000010f00000f001efffff0000100000000001000000000010000000100D000100D00f1
11111D1111110010001f010f10001f010f10010001000011111111111D11111D11111111111111110f01011111f1f1f1f1f11111111100100111111D11
100000000001001000000100000000010000010001001000000000010000100000100000000001000000000010000000000100001000111111f0000f01
100f0000f00100f0011111111101111111110000010010000000000100f0100000100000000001001D1f1f001010101010110010000000100000000001
10000000000100100000010000000001000001000100100000000001000010f0001000000000010000f000001000000000010010000000100000000001
1000000000010010001f010f10001f010f100100010010000000000100001000001000000000010f0f00f0001000000000fD0000100000100000000001
1000f000000100100111010111011101011101000100100000000001D11111110f10000000000100f00f0000111000000001000010f00010000f000001
1000000000010010001001001000100100100100010010000000000100001000001000000000011100f01D111001D1000111111111D111100000000001
1000000f0001001000000000000000000000000001001000000000010f00100000100000000001000000000010000f00000100f0100000100000000001
10000000000D001f11111f111111111f111111111100100000000001000010000010000000000100111100001000001110010f0010000fDf0000000001
1000000000010000000010000000f000100000000000100000000001111f1011101000000000010000000000100000000001f00f100000100000000001
1000000000010000000000000001D100Df00000000001000000000000000001000D00000000001000000010010000000f00100001000001000000f0001
11111D1111111111111111111111f1111111111111111111111111111111D11D1111111111111111f1001f1111111111D1111D111111111111111D1111
100000000001000000000010000001000100000D000f1000D001000D0001010000Df000000000100000000001000001fff00fff1f0000f10f010f0f001
10000000000100000000001000000000010f000111001000100100010001010111100000f000010000110000D0f0001000000001000000100010000001
100000000f0D0000000000111011110000000111f0001000100100010001f1f0001000000000010000000000100000111111111f111D1111D111D11111
100000000001111111100010001ff10001000100011111111f1100010001D11110111011D1111100000000001000000000010000000f0010f010001001
100000000001000000100010000ff100010001000f00D00f000100010000000000100000f0000100f0000000001000f0001000000000001000Df00D0f1
1000000000010000001000111111111111000100011111110001000100111111001000000000010000000000001000000001111D111111100010001001
100000000001000000100010000000000100010f0100f001000000010010f0f10010010000000D000000f0000010000000010000000000111111D11111
10000000000D00f00010001000000000010001000100100100000001001f000100100000000001000000000000100000000000f0000000100000001001
100f00000001000000D0f0D000f000000f000111110010011111111100111D1100100f0000100100000000001000f00000100000000000D00000000001
1000000000010000001000100000000001000D000f00100f0D0000f1000000000010000000000100f00000001000000000010000000000100000010001
11111111111111111111111111111111111111111111111111f00f011111111111111111110111111111D1111111111111111111111111111111111D11
10000000000100000000001000000000010000000000100000000001000000000010000000000100000000001000000000010000000000101000000001
10000000000100000000001000000000010000000000100f000000010000000000100f0000000100f00f00001000000000010000000000100010000001
1000000000010000000000100000000001000000000010f0f000f00100000000001000000000010000f00f001000000000010000000000100000100001
100000000001000000000010000000000100000000001000000000010000000000100000f000010f000000001000000000010000000000100000001001
10000000000100000000001000000000010000000000100f00f0f0010000000000100000000001000f00f0f01000000000010000000000110000000001
1000000000010000000000100000000001000000000010f0000f000100000000001000f00000010f000000001000000000010000000000100100000001
10000000000100000000001000000000010000000000100000f0f00100000000001000000000010000f0f00f1000000000010000000000100000000101
1000000000010000000000100000000001000000000010f000000001000000000010000000f001f00f0000001000000000010000000000100001000001
10000000000100000000001000000000010000000000100000f00f010000000000100f0000000100f00f00f01000000000010000000000100f00010001
10000000000100000000001000000000010000000000100f00000001000000000010000000000100000000001000000000010000000000100000000011
11111111111111111111111111111111111111111111111111111111111111111111111111111111111111111111111111111111111111111111111111
