NO ./img/backroom_wall_2.xpm
SO ./img/backroom_wall_2.xpm
EA ./img/backroom_wall_2.xpm
WE ./img/backroom_wall_2.xpm

C ./img/backroom_ceiling.xpm
F ./img/backroom_floor.xpm

11111111111111111111111111111111111111111111111111111111111111111111111111111111111111111111111111111111111111111111111111
10000000000100000000001000000000000000000000100000000001000000000010000000000100000000001000000000010000000000100000000001
10000000000100000000001000100010000010001000000000000001000000000010000000000100000000001000000000010000000000100000000001
10000000000000000000001001110111000111011100100000000001000000000010000010000100000000001000000000000000000000100000000001
10000000000100000000001000100010000010001000100000000000000000000010000111000100000000001000000000010000000000100000000001
10000000000100000000001000000000000000000000100000000001000000000010000010000000000000001000000000010000000000100000000001
10000000000100000000000000100010000010001000100000000001000000000010000000000100000000001000000000010000000000100000000001
10000000000100000000001001110111000111011100100000000001000000000000000010000100000000001000000000010000000000100000000001
10000000000100000000001000100010000010001000100000000001000000000010000111000100000000000000000000010000000000000000000001
10000000000100000000001000000000000000000000100000000001000000000010000010000100000000001000000000010000000000100000000001
10000000000100000000001000100010000010001000100000000001000000000010000000000100000000001000000000010000000000100000000001
11111011111111101111111001110111000111011100110111111111111111101111111011111111111011111111111011111111111110101111111111
10000000000100000000001000100010000010001000100000000001000000000010000000000100000000001000000000010000000000100000000001
10000000000100000000001000000000000000000000100110111101000000000010000000000100010001001000000000010000000000100000000001
10000000000100000000001000100010000010001000100100000101000000000010000010000100111011101000000000010000000000100000000001
10000000000100000000001001110111000111011100000100100101000000000010000111000100010001001000000000010000000000100000000001
10000000000100000000001000100010000010001000100101110101000000000010000010000100000000001000000000010000000000100000000001
10000000000100000000001000000000000000000000100100100101000000000010000000000100000000001000000000010000000000100000000001
10000000000100000000001000100010000010001000100100000100000000000010000010000100010001001000000000010000000000100000000001
10000000000100000000001001110111000111011100100100000101000000000010000111000100111011101000000000010000000000100000000001
10000000000100000000001000100010000010001000000111111101000000000010000010000100010001001000000000010000000000100000000001
10000000000100000000001000000000000000000000100000000001000000000010000000000100000000001000000000010000000000100000000001
11111111011111011111111101111111011111101111111110111111111111011111111101111111101111111101111111111111110111111011111111
10000000000100000000000000000000000000000000100000000001000000000010000000000100000000001000000000010000000000100000000001
10000000000100000011111111110111111111111000100000000001000000000010000000000100000000001000000000010000000000100000000001
10000000000000010010000000010100110000001000000000000001000000000010000000000100000000001000000000010000000000100000000001
10000000000100111000000000000010000000101000100000000001000000000010000000000100000000001000000000010000000000100000000001
10000000000100010010011111111110111110100000100000000001000000000010000000000100000000001000000000010000000000100000000001
1000000000010000001001000000100001000010100010000000000000000N000000000000000100000000001000000000010000000000100000000001
10000000000100010010010011111001010110101000100000000001000000000010000000000100000000001000000000010000000000100000000001
10000000000100111010000000000000000000001000000000000001000000000010000000000100000000001000000000010000000000100000000001
10000000000100010010001111111111111111111000100000000001000000000010000000000100000000001000000000010000000000100000000001
10000000000100000010001000000000000000000000100000000001000000000010000000000100000000001000000000010000000000100000000001
11111011111101111111101011111111111111111110101111111101111110111111111111111111111111111111111111111111111111111111011111
10000000000100000000001000000000000000000000100000000001000000000010000000000100000000001000000000010000000000100000000001
10000000000100000000001000000000010000000000100000000001000000000010000000000100000000001000000000010000000000100000000001
10000000000100000000001001000010010010000100100000000001000000000010000000000100000000001000000000010000000000100000000001
10000000000100000000001000000000010000000000100000000001000000000010000000000100000000001000000000010000000000100000000001
10000000000100000000001000000000010000000000100000000001000000000010000000000100000000001000000000010000000000100000000001
10000000000000000000001001000010010010000100100000000001000000000010000000000100000000001000000000010000000000100000000001
10000000000100000000001000000000000000000000100000000001000000000010000000000100000000001000000000010000000000100000000001
10000000000100000000001000000000010000000000100000000001000000000010000000000100000000001000000000010000000000100000000001
10000000000100000000001001000010010010000100100000000001000000000010000000000100000000001000000000010000000000100000000001
10000000000100000000001000000000010000000000000000000001000000000010000000000100000000001000000000010000000000100000000001
11011111111111111111111111111111010111111110101111111101111110111111111111111111111111111111111111111111111111111111111111
10000000000100000000000000000000000000000000000000000001000000000010000000000100000000001000000000010000000000100000000001
10000000000100000000000000000000000000000000100000000001000000000010000000000100000000001000000000010000000000100000000001
10000000000100111111111111111011111111111100100000000001000000000010000000000100000000001000000000010000000000100000000001
10000000000100100000000000000000000000000100100000000001000000000010000000000100000000001000000000010000000000100000000001
10000000000100000000001111111111111100000000100000000001000000000010000000000100000000001000000000010000000000100000000001
10000000000100100000000000000000000000000100100000000001000000000010000000000100000000001000000000010000000000100000000001
10000000000100101111111111011111111111000100100000000001000000000010000000000100000000001000000000010000000000100000000001
10000000000100100000000000000000000001000100100000000000000000000010000000000100000000001000000000010000000000100000000001
10000000000100100010010010001001001001000100100000000001000000000010000000000100000000001000000000010000000000100000000001
10000000000100100111010111011101011101000100100000000001000000000010000000000100000000001000000000010000000000100000000001
11111011111100100010010010001001001001000100001111111111101111101111111111111111111111111111111111111111111111111111111111
10000000000100100000010000000001000001000100100000000001000010000010000000000100000000001000000000010000000000100000000001
10000000000100000111111111011111111100000100100000000001000010000010000000000100000000001000000000010000000000100000000001
10000000000100100000010000000001000001000100100000000001000010000010000000000100000000001000000000010000000000100000000001
10000000000100100010010010001001001001000100100000000001000010000010000000000100000000001000000000010000000000100000000001
10000000000100100111010111011101011101000100100000000001011111110010000000000100000000001000000000010000000000100000000001
10000000000100100010010010001001001001000100100000000001000010000010000000000100000000001000000000010000000000100000000001
10000000000100100000000000000000000000000100100000000001000010000010000000000100000000001000000000010000000000100000000001
10000000000000101111101111111110111111111100100000000001000010000010000000000100000000001000000000010000000000100000000001
10000000000100000000100000000000100000000000100000000001111010111010000000000100000000001000000000010000000000100000000001
10000000000100000000000000010100000000000000100000000000000000100000000000000100000000001000000000010000000000100000000001
11111011111111111111111111110111111111111111111111111111111101101111111111111111111111111111111111111111111111111111111111
10000000000100000000001000000100010000000000100000010000000101000000000000000100000000001000000000010000000000100000000001
10000000000100000000001000000000010000011100100010010001000101011110000000000100000000001000000000010000000000100000000001
10000000000000000000001110111100000001110000100010010001000101000010000000000100000000001000000000010000000000100000000001
10000000000111111110001000100100010001000111111110110001000101111010000000000100000000001000000000010000000000100000000001
10000000000100000010001000000100010001000000000000010001000000000010000000000100000000001000000000010000000000100000000001
10000000000100000010001111111111110001000111111100010001001111110010000000000100000000001000000000010000000000100000000001
10000000000100000010001000000000010001000100000100000001001000010010000000000100000000001000000000010000000000100000000001
10000000000000000010001000000000010001000100100100000001001000010010000000000100000000001000000000010000000000100000000001
10000000000100000000000000000000000001111100100111111111001100110010000000000100000000001000000000010000000000100000000001
10000000000100000010001000000000010000000000100000000001000000000010000000000100000000001000000000010000000000100000000001
11111111111111111111111111111111111111111111111111000001111111111111111111111111111111111111111111111111111111111111111111
10000000000100000000001000000000010000000000100000000001000000000010000000000100000000001000000000010000000000100000000001
10000000000100000000001000000000010000000000100000000001000000000010000000000100000000001000000000010000000000100000000001
10000000000100000000001000000000010000000000100000000001000000000010000000000100000000001000000000010000000000100000000001
10000000000100000000001000000000010000000000100000000001000000000010000000000100000000001000000000010000000000100000000001
10000000000100000000001000000000010000000000100000000001000000000010000000000100000000001000000000010000000000100000000001
10000000000100000000001000000000010000000000100000000001000000000010000000000100000000001000000000010000000000100000000001
10000000000100000000001000000000010000000000100000000001000000000010000000000100000000001000000000010000000000100000000001
10000000000100000000001000000000010000000000100000000001000000000010000000000100000000001000000000010000000000100000000001
10000000000100000000001000000000010000000000100000000001000000000010000000000100000000001000000000010000000000100000000001
10000000000100000000001000000000010000000000100000000001000000000010000000000100000000001000000000010000000000100000000001
11111111111111111111111111111111111111111111111111111111111111111111111111111111111111111111111111111111111111111111111111
