NO ./img/backroom_wall.xpm
SO ./img/backroom_wall.xpm
EA ./img/backroom_wall.xpm
WE ./img/backroom_wall.xpm
F 187,135,57
C 130,130,100

111111111111111111111111111111111111111111111111111111111111111111111111111111111111111111111111111111
100000000000000011000000000000000110000000000000001100000000000000011000000000000000110000000000000001
100000000000000011000000000000000110000000000000001100000000000000011000000000000000110000000000000001
100000000000000011000000000000000110000000000000001100000000000000011000000000000000110000000000000001
100000000000000000000000000000000000000000000000000000000000000000000000000000000000000000000000000001
100000000000000011000000000000000110000000000000001100000000000000011000000000000000110000000000000001
100000000000000011000000000000000110000000000000001100000000000000011000000000000000110000000000000001
111111110111111111111111101111111111111111011111111111111110111111111111111101111111111111111011111111
111111110111111111111111101111111111111111011111111111111110111111111111111101111111111111111011111111
100000000000000011000000000000000110000000000000001100000000000000011000000000000000110000000000000001
100000000000000011000000000000000110000000000000001100000000000000011000000000000000110000000000000001
100000000000000011000000000000000110000000000000001100000000000000011000000000000000110000000000000001
100000000000000000000000000000000000000000000000000000000000000000000000000000000000000000000000000001
100000000000000011000000000000000110000000000000001100000000000000011000000000000000110000000000000001
100000000000000011000000000000000110000000000000001100000000000000011000000000000000110000000000000001
111111110111111111111111101111111111111111011111111111111110111111111111111101111111111111111011111111
111111110111111111111111101111111111111111011111111111111110111111111111111101111111111111111011111111
100000000000000011000000000000000110000000000000001100000000000000011000000000000000110000000000000001
100000000000000011000000000000000110000000000000001100000000000000011000000000000000110000000000000001
100000000000000011000000000000000110000000000000001100000000000000011000000000000000110000000000000001
100000000000000000000000000000000000000000N00000000000000000000000000000000000000000000000000000000001
100000000000000011000000000000000110000000000000001100000000000000011000000000000000110000000000000001
100000000000000011000000000000000110000000000000001100000000000000011000000000000000110000000000000001
111111110111111111111111101111111111111111011111111111111110111111111111111101111111111111111011111111
111111110111111111111111101111111111111111011111111111111110111111111111111101111111111111111011111111
100000000000000011000000000000000110000000000000001100000000000000011000000000000000110000000000000001
100000000000000011000000000000000110000000000000001100000000000000011000000000000000110000000000000001
100000000000000011000000000000000110000000000000001100000000000000011000000000000000110000000000000001
100000000000000000000000000000000000000000000000000000000000000000000000000000000000000000000000000001
100000000000000011000000000000000110000000000000001100000000000000011000000000000000110000000000000001
100000000000000011000000000000000110000000000000001100000000000000011000000000000000110000000000000001
111111110111111111111111101111111111111111011111111111111110111111111111111101111111111111111011111111
111111110111111111111111101111111111111111011111111111111110111111111111111101111111111111111011111111
100000000000000011000000000000000110000000000000001100000000000000011000000000000000110000000000000001
100000000000000011000000000000000110000000000000001100000000000000011000000000000000110000000000000001
100000000000000011000000000000000110000000000000001100000000000000011000000000000000110000000000000001
100000000000000000000000000000000000000000000000000000000000000000000000000000000000000000000000000001
100000000000000011000000000000000110000000000000001100000000000000011000000000000000110000000000000001
100000000000000011000000000000000110000000000000001100000000000000011000000000000000110000000000000001
111111111111111111111111111111111111111111111111111111111111111111111111111111111111111111111111111111
