NO 100,100,100
SO 100,100,100
WE 100,100,100
EA 100,100,100
C 0,0,0
F 0,0,0
D ./img/bricks.xpm



11111111111111111111111111111111
1dddddddddddddddddddddddddddddd1
1dddddddddddddddddddddddddddddd1
1dddddddddddddddddddddddddddddd1
1dddddddddddddddddddddddddddddd1
1dddddddddddddddddddddddddddddd1
1dddddddddddddddddddddddddddddd1
1dddddddddddddddddddddddddddddd1
1dddddddddddddddddddddddddddddd1
1dddddddddddddddddddddddddddddd1
1dddddddddddddddddddddddddddddd1
1dddddddddddddddddddddddddddddd1
1dddddddddddddddddddddddddddddd1
1dddddddddddddddddddddddddddddd1
1dddddddddddddddddddddddddddddd1
1ddddddddddddddNddddddddddddddd1
1dddddddddddddddddddddddddddddd1
1dddddddddddddddddddddddddddddd1
1dddddddddddddddddddddddddddddd1
1dddddddddddddddddddddddddddddd1
1dddddddddddddddddddddddddddddd1
1dddddddddddddddddddddddddddddd1
1dddddddddddddddddddddddddddddd1
1dddddddddddddddddddddddddddddd1
1dddddddddddddddddddddddddddddd1
1dddddddddddddddddddddddddddddd1
1dddddddddddddddddddddddddddddd1
1dddddddddddddddddddddddddddddd1
1dddddddddddddddddddddddddddddd1
1dddddddddddddddddddddddddddddd1
1dddddddddddddddddddddddddddddd1
11111111111111111111111111111111