NO ./img/korosensei.xpm ./img/bricks.xpm


SO ./img/korosensei.xpm ./img/bricks.xpm

EA ./img/bricks.xpm ./img/korosensei.xpm
WE   ./img/bricks.xpm  ./img/korosensei.xpm




D ./img/Tardis.xpm


F ./img/circles.xpm


C 30,0,0


f ./img/enemy_korosensei.xpm
ex ./img/explosion_1_0.xpm ./img/explosion_1_1.xpm ./img/explosion_1_2.xpm ./img/explosion_1_3.xpm

11111111111111111111111111111111111111111111111111111111111111111111111111111111
1000000000000f0000000000000000000f00000000000000000000000000000000000f0000000001
1000000000000000000000000f000000000000000000000000000000000000000000000000000001
100000011111111111111100000000100000f0000000000000010000000000000000000001000001
10000f01000000000000000000000010000000000000000000001000000000f00000000010000f01
100000010000D0000000000000000010000000000000000000000100f00000000000f00100000001
100000010000000f000000000000001000f000000000f00000000010000000000000001000000001
10f00001000000000000000000000010000000000000000000000001000000D00000010000000001
1000000111111111110000000f000010000000000000000000000000100000000000100000000001
10000001000000000000000000000010000000f00000000000000000010000000001000000000001
1000000100000000000000000000001000000000000000000000000000100000001000000f000001
10000f010000D0000000000000000010000000000000000000000000000100000100000000000001
100000010000000f0000000000000010D0000000000f000000000f00000010001000000000000001
10f00001000000000000000000000010000000000000000000000000000001010000f00000000f01
10000001111111111111110000000011111111111111110000000000000000100000000000100001
1000000000000000000000000000000000000000000000000000f000000000000000000000000001
100f00000f0000000000f00f00f00f00f00f0000000000000000000000000000000000000W000001
100000000000000000000000000000000000000000000000000000000000000000000f00000000f1
11111111111111111111111111111111111111111111111111111111111111111111111111111111