NO 200,0,0
SO 250,80,0
EA 0,130,0
WE 0,0,200
F 250,250,250
C 200,200,0

1111111
1000001
1000001
1001001
1000001
100N001
1111111
