NO 100,100,100
SO 80,80,80
EA 70,70,70
WE 60,60,60
F 50,50,50
C 110,110,110

D 200,200,200

1111111111111111111111111111111111111111111111111111
1000000000000000000000000000000000000000000000000001
1000000000000000000000000000000000000000000000000001
1001111111111111111111111111111111111111111111110001
1001000000000000000000000000000000000000000000010001
1001000000000000000000000000000000000000000000010001
1001000111111111111111111111111111111111111100010001
1001000100000000000000000000000000000000000100010001
1001000100000000000000000000000000000000000100010001
1001000100011111111111111111111111111111000100010001
1001000100010000000000000000000000000001000100010001
1001000100010000000000000000000000000001000100010001
1001000100010011111111111111111111110001000100010001
1001000100010010000000000000000000010001000100010001
1001000100010010000000000000000000010001000100010001
1001000100010010011111111111111110010001000100010001
1001000100010010010000000000000010010001000100010001
1001000100010010010000000000000010010001000100010001
1001000100010010010011111111110010010001000100010001
1001000100010010010010000000010010010001000100010001
1001000100010010010010000000010010010001000100010001
1001000100010010010010011110010010010001000100010001
1001000100010010010010010010010010010001000100010001
1001000100010010010010010010010010010001000100010001
1001000100010010010010011010010010010001000100010001
1001000100010010010010010010010010010001000100010001
1001000100010010010010010110010010010001000100010001
1001000100010010010010010010010010010001000100010001
1001000100010010010010011010010010010001000100010001
1001000100010010010010000010010010010001000100010001
1001000100010010010011111110010010010001000100010001
1001000100010010010000000000010010010001000100010001
1001000100010010010000000000010010010001000100010001
1001000100010010011111111111110010010001000100010001
1001000100010010000000000000000010010001000100010001
1001000100010010000000000000000010010001000100010001
1001000100010011111111111111111110010001000100010001
1001000100010000000000000000000000010001000100010001
1001000100010000000000000000000000010001000100010001
1001000100011111111111111111111111110001000100010001
1001000100000000000000000000000000000001000100010001
1001000100000000000000000000000000000001000100010001
1001000111111111111111111111111111111111000100010001
1001000000000000000000000000000000000000000100010001
1001000000000000000000000000000000000000000100010001
1001111111111111111111111111111111111111111100010001
1000000000000000000000000000000000000000000000010001
1000000000000000000000000000000000000000000000010001
1111111111111111111111111111111111111111111111110001
1000000000000000000000000000000000000000000000000001
1E00000000000000000000000000000000000000000000000001
1111111111111111111111111111111111111111111111111111