NO ./img/brick_torch_1.xpm ./img/brick_torch_2.xpm ./img/brick_torch_3.xpm
SO ./img/brick_torch_1.xpm ./img/brick_torch_2.xpm ./img/brick_torch_3.xpm
EA ./img/brick_torch_1.xpm ./img/brick_torch_2.xpm ./img/brick_torch_3.xpm
WE ./img/brick_torch_1.xpm ./img/brick_torch_2.xpm ./img/brick_torch_3.xpm
F 0,25,0
C 0,0,25

D ./img/wood.xpm

111111111111111111111111100
100000000011000000000000100
101100000111000000000000100
10010000000D000000000000111111111
111111111011000001110000D00000001
10000000001100000111D111111111111
11110111111111D11100000010001
1111D111111111011101010010001
110000001101010111000000D0001
10000000000000001100000010001
10000000000000001101010010001
11000001110101011111011110N0111
11110111 11101010101111010001
11111111 1111111011111111111100
