NO  31,0,0 63,0,0 95,0,0 127,0,0 159,0,0 191,0,0 223,0,0 255,0,0 223,0,0 191,0,0 159,0,0 127,0,0 95,0,0 63,0,0 31,0,0
WE  0,31,0 0,63,0 0,95,0 0,127,0 0,159,0 0,191,0 0,223,0 0,255,0 0,223,0 0,191,0 0,159,0 0,127,0 0,95,0 0,63,0 0,31,0
F  0,0,31 0,0,63 0,0,95 0,0,127 0,0,159 0,0,191 0,0,223 0,0,255 0,0,223 0,0,191 0,0,159 0,0,127 0,0,95 0,0,63 0,0,31
EA  31,31,0 63,63,0 95,95,0 127,127,0 159,159,0 191,191,0 223,223,0 255,255,0 223,223,0 191,191,0 159,159,0 127,127,0 95,95,0 63,63,0 31,31,0
SO  31,0,31 63,0,63 95,0,95 127,0,127 159,0,159 191,0,191 223,0,223 255,0,255 223,0,223 191,0,191 159,0,159 127,0,127 95,0,95 63,0,63 31,0,31
C  0,31,31 0,63,63 0,95,95 0,127,127 0,159,159 0,191,191 0,223,223 0,255,255 0,223,223 0,191,191 0,159,159 0,127,127 0,95,95 0,63,63 0,31,31

D 0,0,0 40,40,40 80,80,80 120,120,120 160,160,160 200,200,200 240,240,240 255,255,255 220,220,220 180,180,180 140,140,140 100,100,100 60,60,60 20,20,20 0,0,0


111111111111111111111111100
100000000011000000000000100
1D110000011100000E000000100
10010000000D000000000000111111111
111111111D11000001110000D00000001
10000000001100000111D111111111111
1111D111111111D11100000010001
1111D111111111011101010010001
1100000011D1D10111000000D0001
10000000000000001100000010001
10000000000000001101D10010001
1100000111D1D1D1111101111000111
1111D111 11101010101111010001
11111111 1111111011111111111100
