NO  31,0,0 63,0,0 95,0,0 127,0,0 159,0,0 191,0,0 223,0,0 255,0,0 223,0,0 191,0,0 159,0,0 127,0,0 95,0,0 63,0,0 31,0,0
WE  0,31,0 0,63,0 0,95,0 0,127,0 0,159,0 0,191,0 0,223,0 0,255,0 0,223,0 0,191,0 0,159,0 0,127,0 0,95,0 0,63,0 0,31,0
F  0,0,31 0,0,63 0,0,95 0,0,127 0,0,159 0,0,191 0,0,223 0,0,255 0,0,223 0,0,191 0,0,159 0,0,127 0,0,95 0,0,63 0,0,31
EA  31,31,0 63,63,0 95,95,0 127,127,0 159,159,0 191,191,0 223,223,0 255,255,0 223,223,0 191,191,0 159,159,0 127,127,0 95,95,0 63,63,0 31,31,0
SO  31,0,31 63,0,63 95,0,95 127,0,127 159,0,159 191,0,191 223,0,223 255,0,255 223,0,223 191,0,191 159,0,159 127,0,127 95,0,95 63,0,63 31,0,31
C  0,31,31 0,63,63 0,95,95 0,127,127 0,159,159 0,191,191 0,223,223 0,255,255 0,223,223 0,191,191 0,159,159 0,127,127 0,95,95 0,63,63 0,31,31

111111111111111111111111100
100000000011000000000000100
10110000011100000E000000100
100100000000000000000000111111111
111111111011000001110000000000001
100000000011000001110111111111111
11110111111111011100000010001
11110111111111011101010010001
11000000110101011100000000001
10000000000000001100000010001
10000000000000001101010010001
1100000111010101111101111000111
11110111 11101010101111010001
11111111 1111111011111111111100
