NO ./img/warning.xpm
SO ./img/warning.xpm
EA ./img/warning.xpm
WE ./img/warning.xpm
F ./img/warning.xpm
C ./img/warning.xpm



1111111111111111111111111111111111111111111111111
1000000000000000000000000000000000000000000000001
1010101010101010101010101010101010101010101010101
1000000000000000000000000000000000000000000000001
1010101010101010101010101010101010101010101010101
1000000000000000000000000000000000000000000000001
1010101010101010101010101010101010101010101010101
1000000000000000000000000000000000000000000000001
1010101010101010101010101010101010101010101010101
1000000000000000000000000000000000000000000000001
1010101010101010101010101010101010101010101010101
1000000000000000000000N00000000000000000000000001
1010101010101010101010101010101010101010101010101
1000000000000000000000000000000000000000000000001
1010101010101010101010101010101010101010101010101
1000000000000000000000000000000000000000000000001
1010101010101010101010101010101010101010101010101
1000000000000000000000000000000000000000000000001
1010101010101010101010101010101010101010101010101
1000000000000000000000000000000000000000000000001
1010101010101010101010101010101010101010101010101
1111111111111111111111111111111111111111111111111
