NO ./img/circles.xpm
SO ./img/circles.xpm
EA ./img/circles.xpm
WE ./img/circles.xpm
F 0,50,100
C 0,50,20
11111111111111111111111111111111111111111111111111111111111111111111111111111111
10000000000000000000000000000000000000000000000000000000000000000000000000000001
10000000000000000000000000000000000000000000000000000000000000000000000000000001
10000001111111111111110000000010000000000000000000010000000000000000000001000001
10000001000000000000000000000010000000000000000000001000000000000000000010000001
10000001000000000000000000000010000000000000000000000100000000000000000100000001
10000001000000000000000000000010000000000000000000000010000000000000001000000001
10000001000000000000000000000010000000000000000000000001000000000000010000000001
10000001111111111100000000000010000000000000000000000000100000000000100000000001
10000001000000000000000000000010000000000000000000000000010000000001000000000001
10000001000000000000000000000010000000000000000000000000001000000010000000000001
10000001000000000000000000000010000000000000000000000000000100000100000000000001
10000001000000000000000000000010000000000000000000000000000010001000000000000001
10000001000000000000000000000010000000000000000000000000000001010000000000000001
10000001111111111111110000000011111111111111110000000000000000100000000000100001
10000000000000000000000000000000000000000000000000000000000000000000000000000001
1000000000000000000000000000000000000000000000000000000000000000000000000W000001
10000000000000000000000000000000000000000000000000000000000000000000000000000001
11111111111111111111111111111111111111111111111111111111111111111111111111111111